Register   |    Hex |      Dec
------------------------------
       100 |   0000 |        0
       101 |   0000 |        0
       102 |   0000 |        0
       103 |   0000 |        0
       104 |   0040 |       64 	// Ezek egyenként 0-át adnak vissza, de csoportosan ok
       105 |   0240 |      576 	// Ezek egyenként 0-át adnak vissza, de csoportosan ok
       106 |   0000 |        0
       107 |   0000 |        0
       108 |   0040 |       64 	// Ezek egyenként 0-át adnak vissza, de csoportosan ok
       109 |   0040 |       64 	// Ezek egyenként 0-át adnak vissza, de csoportosan ok
       110 |   0000 |        0
       111 |   0000 |        0
       112 |   12A8 |     4776
       113 |   3833 |    14387
       114 |   0000 |        0
       115 |   0000 |        0
       116 |   0000 |        0
       117 |   0000 |        0
       118 |   0000 |        0
       119 |   0000 |        0
       120 |   0000 |        0
       121 |   0000 |        0
       122 |   0000 |        0
       123 |   0000 |        0
       124 |   0000 |        0
       125 |   0000 |        0
       126 |   0000 |        0
       127 |   0000 |        0
       128 |   0000 |        0
       129 |   0000 |        0
       130 |   0000 |        0
       131 |   0000 |        0
       132 |   0000 |        0
       133 |   0000 |        0
       134 |   0000 |        0
       135 |   0000 |        0
       136 |   0000 |        0
       137 |   0000 |        0
       138 |   0000 |        0
       139 |   0000 |        0
       140 |   0000 |        0
       141 |   0000 |        0
       142 |   0000 |        0
       143 |   0000 |        0
       144 |   0000 |        0
       145 |   0000 |        0
       146 |   0000 |        0
       147 |   0000 |        0
       148 |   0000 |        0
       149 |   0000 |        0
       150 |   0000 |        0
       151 |   0000 |        0
       152 |   0000 |        0
       153 |   0000 |        0
       154 |   0000 |        0
       155 |   0000 |        0
       156 |   0000 |        0
       157 |   0000 |        0
       158 |   0000 |        0
       159 |   0000 |        0
       160 |   0000 |        0
       161 |   0000 |        0
       162 |   0000 |        0
       163 |   0000 |        0
       164 |   0000 |        0
       165 |   0000 |        0
       166 |   0000 |        0
       167 |   0000 |        0
       168 |   0000 |        0
       169 |   0000 |        0
       170 |   0000 |        0
       171 |   8401 |    33793	Equipment type
       172 |   3030 |    12336
       173 |   3030 |    12336
       174 |   0000 |        0
       175 |   0000 |        0
       176 |   0000 |        0
       177 |   0000 |        0
       178 |   0000 |        0
       179 |   0000 |        0
       180 |   0000 |        0
       181 |   0000 |        0
       182 |   0000 |        0
       183 |   0000 |        0
       184 |   0004 |        4
       185 |   0000 |        0
       186 |   3932 |    14642
       187 |   4233 |    16947
       188 |   3235 |    12853
       189 |   3035 |    12341
       190 |   3130 |    12592
       191 |   3538 |    13624
       192 |   3533 |    13619
       193 |   0000 |        0
       194 |   0000 |        0
       195 |   0000 |        0
       196 |   0000 |        0
       197 |   0000 |        0
       198 |   0C44 |     3140
       199 |   0000 |        0
       200 |   9000 |   -32127
       201 |   0004 |        2
       202 |   0000 |        0
       203 |   1389 |     5003	Grid Frequency(Hz) (* 0,01)
       204 |   0000 |        0
       205 |   0000 |        0
       206 |   0000 |       74
       207 |   0304 |      260
       208 |   0000 |        0
       209 |   0000 |        0
       210 |   0000 |        0
       211 |   0000 |        0
       212 |   0000 |        0
       213 |   0000 |        0
       214 |   0000 |        0
       215 |   0000 |        0
       216 |   0000 |        0
       217 |   0000 |        0
       218 |   0000 |        0
       219 |   0000 |        0
       220 |   0000 |        0
       221 |   0000 |        0
       222 |   0000 |        0
       223 |   0000 |        0
       224 |   0000 |        0
       225 |   0000 |        0
       226 |   0000 |        0
       227 |   1388 |     5002
       228 |   0000 |        0
       229 |   0000 |        0
       230 |   0000 |        2
       231 |   001F |       36
       232 |   0000 |        0
       233 |   0000 |        0
       234 |   0000 |        0
       235 |   0000 |        0
       236 |   0000 |        0
       237 |   0000 |        0
       238 |   0000 |        0
       239 |   0000 |        0
       240 |   0000 |        0
       241 |   0000 |        0
       242 |   0000 |        0
       243 |   0000 |        0
       244 |   0000 |        0
       245 |   0000 |        0
       246 |   0000 |        0
       247 |   0000 |        0
       248 |   0000 |        0
       249 |   0000 |        0
       250 |   0000 |        0
       251 |   0000 |        0
       252 |   0008 |      112     Total Output Current(A) (*0,01)
       253 |   138B |     5003     Output freq ??? or 227???
       254 |   0000 |     2586     Total Output Active Power(W)
       255 |   00BE |     2642	Total Output Aparent Power(VA)
       256 |   0001 |       24
       257 |   0000 |        0
       258 |   0000 |        0
       259 |   0000 |        0
       260 |   0000 |        0
       261 |   0000 |        0
       262 |   0000 |        0
       263 |   0000 |        0
       264 |   0000 |        0
       265 |   0000 |        0
       266 |   0000 |        0
       267 |   0000 |        0
       268 |   0000 |        0
       269 |   0000 |        0
       270 |   0000 |        0
       271 |   0000 |        0
       272 |   0000 |        0
       273 |   0000 |        0
       274 |   0000 |        0
       275 |   0000 |        0
       276 |   0000 |        0
       277 |   0002 |      539	Battery Voltage(V) (* 0,1)
       278 |   FFF9 |       -6     Battery Current(A) (* 0,1)
       279 |   0000 |      -36	Battery Power(W) ???
       280 |   0005 |      100	SOC (%)
       281 |   001A |       29	DC Module Termperature(°C)
       282 |   0000 |        0
       283 |   0000 |        0
       284 |   0000 |        0
       285 |   0000 |        0
       286 |   0000 |        0
       287 |   0000 |        0
       288 |   0000 |        0
       289 |   0000 |        0
       290 |   0000 |        0
       291 |   0000 |        0
       292 |   0000 |        0
       293 |   0000 |        0
       294 |   0000 |        0
       295 |   0000 |        0
       296 |   0000 |        0
       297 |   0000 |        0
       298 |   0000 |        0
       299 |   0000 |        0
       300 |   0000 |        0
       301 |   0000 |        0
       302 |   0000 |        0
       303 |   0000 |        0
       304 |   0000 |        0
       305 |   001b |       23	PV temperature(°C) ???
       306 |   0000 |        0
       307 |   0000 |        0
       308 |   0000 |        0
       309 |   0000 |        0
       310 |   0000 |        0
       311 |   0000 |        0
       312 |   0000 |        0
       313 |   0000 |        0
       314 |   0000 |        0
       315 |   0000 |        0
       316 |   0000 |        0
       317 |   0000 |        0
       318 |   0000 |        0
       319 |   0000 |        0
       320 |   0000 |        0
       321 |   0000 |        0
       322 |   0000 |        0
       323 |   0000 |        0
       324 |   0000 |        0
       325 |   0000 |        0
       326 |   0000 |        0
       327 |   0000 |        0
       328 |   0000 |        0
       329 |   0000 |        0
       330 |   0000 |        0
       331 |   0000 |        0
       332 |   0000 |        0
       333 |   0000 |        0
       334 |   0000 |        0
       335 |   0000 |        0
       336 |   0000 |        0
       337 |   0000 |        0
       338 |   0965 |     2377	???
       339 |   0000 |        0
       340 |   0000 |      584
       341 |   0000 |        0
       342 |   0964 |     2376	???
       343 |   0007 |        5
       344 |   000b |        4
       345 |   0000 |        0
       346 |   0964 |     2376	Output L1 Voltage ??? (* 0,1)
       347 |   0004 |       36	Output L1 Current(A) (* 0,1)
       348 |   0008 |      583	Output L1 Active Power(W)
       349 |   0060 |      855     Output L1 Apparent Power(VA)
       350 |   0000 |        7
       351 |   00aa |      265	PV1 Voltage(V)
       352 |   0000 |        0
       353 |   0000 |        0
       354 |   0000 |        0
       355 |   0000 |        0
       356 |   0000 |        0
       357 |   0000 |        0
       358 |   0000 |        0
       359 |   0000 |        0
       360 |   0000 |        0
       361 |   0000 |        0
       362 |   0000 |        0
       363 |   0000 |        0
       364 |   0000 |        0
       365 |   0000 |        0
       366 |   0000 |        0
       367 |   0000 |        0
       368 |   0000 |        0
       369 |   0000 |        0
       370 |   0000 |        0
       371 |   0000 |        0
       372 |   0000 |        0
       373 |   0000 |        0
       374 |   0000 |        0
       375 |   0000 |        0
       376 |   0000 |        0
       377 |   0000 |        0
       378 |   0000 |        0
       379 |   0000 |        0
       380 |   0000 |        0
       381 |   0000 |        0
       382 |   0000 |        0
       383 |   0000 |        0
       384 |   097d |        0	Output L2 Voltage(V) (* 0,1)
       385 |   0005 |        0	Output L2 Current(A) (* 0,1)
       386 |   fffb |        0     Output L2 Active Power(W)
       387 |   0079 |        0	Output L2 Apparent Power(VA)
       388 |   0002 |        0
       389 |   00a7 |      264	PV2 Voltage(V)
       390 |   0000 |        0
       391 |   0000 |        0
       392 |   0000 |        0
       393 |   0000 |        0
       394 |   0000 |        0
       395 |   0000 |        0
       396 |   0000 |        0
       397 |   0000 |        0
       398 |   0000 |        0
       399 |   0000 |        0

